NO ./textures/north.xpm
SO ./textures/south.xpm
WE ./textures/west.xpm
EA ./textures/east.xpm
F 220,100,0			
C 225,30,0
1111111111111111111
1001001000001001001
100100100001001001
1001001000001001001
1001001000001001001
100000000S000000001
1000011111111000001
1111000000000001111
1000000101010000001
1111111111111111111
