NO ./textures/north.xpm
SO ./textures/south.xpm
WE ./textures/west.xpm
EA ./textures/east.xpm
F 220,100,0
C 225,30,0
1111111111111111111
1001001001001001001
1001001001001001001
1001001001001001001
1001001000E01001001         
1000000000000000001
1000011010011111101
1111000000000001111  
1000000101010000001
1111111111111111111
