
        SO ./textures/south.xpm    
F 0, 150      ,150                                                           		
NO 																											./textures/north.xpm
WE                        ./textures/west.xpm
EA                                                    ./textures/east.xpm

C 225, 30, 256

11111111
11011E01 
1111111111   1
11111111